abandon	abondon
abbreviate	abreviate
abbreviated	abbriviated
abbreviation	abbriviation	abreviation
aberrant	abberant
aberration	abberation	aberation
ability	abillity	abilty
abortifacient	abortificant
about, bout	baout
abscess	abcess
absence	abscence	absense
absorbed	asorbed
absorption	absorbsion	absorbtion
abundance	abundence
abundances	abundacies	abundancies
abundant	abundent	abundunt
abuts	abutts
academic	acadmic	acedemic
academy	acadamy	accadamy	accademy
accelerate	accellerate
accelerating	accellerating
acceleration	accelleration
acceptable	acceptible
accessed	accesed
accessible	accessable
accession, ascension	accension
accessory	accesory
accidentally	accidentaly	accidently
acclimatization	acclimitization
accolade	acolade
accommodate	accomadate	accomodate
accommodation	accomadation	accomodation
accompanied	accompanyed
accomplish	acomplish
accomplished	acomplished
accomplishment	acomplishment
according	accoring	acording
accordingly	acordingly
accordion	accordeon	accordian
accredit	accreditate
accuracy	acuracy
accused	accussed
accustom	acustom
accustomed	acustommed
achieve	acheive	archive	achive
achieved	acheived
achieved, archived	achived
achievement	acheivement	acheivment	achievment
achieves	acheives
achieving	acheiving
acoustic	accoustic
acquaintance	acquaintence	acquiantence	aquaintance	aquiantance
acquaintances	acquiantences
acquainted	aquainted
acquire	adquire	aquire
acquired	aquired
acquiring	adquiring	aquiring
acquisition	aquisition
acquitted	acquited	aquitted
across	accros	accross
activities	activites
actually	actualy	acutally
addition	addtion	adition
additionally	additinally
address	adres	adress
addressable	addresable	adresable	adressable
address, adders	addres
addressing	addresing	adresing
addressing, dressing	adressing
adequate	adecuate
adhering	adhearing
adjacent	ajacent
adjoin	ajoin
adjoining	ajoining
adjust	ajust
administrate	adminstrate
administration	administartion	adminstration
administrative	adminstrative
administrator	adminstrator
admissibility	admissability
admissible	admissable
admission	addmission
admit	admitt
admitted	admited
admitting	admiting
adolescent	adolecent
adopt	addopt
adopted	addopted
adoptive	addoptive
advantageous	advantagous
advertisement	advertisment
advertisements	advertisments
advised	adviced
aerial	aeriel
aerials	aeriels
aerial view	arial view	ariel view
aesthetical, esthetical	asthetical
aesthetically, esthetically	asthetically
aesthetic, esthetic	asthetic
affidavit	affadavit
affiliate	affilate
afford, effort	affort
aficionado	afficionado
afraid	affraid
after	affter
after-effect	after-affect
aftereffect	afteraffect
after which	afterwhich
again	agian
again, angina	agina
against	againnst	agains	aginst
aggravate	agravate
aggregate, agre'gate	agregate
aggregation, agre'gation	agregation
aggression	agression
aggressive	aggresive	agressive
aggressively	agressively
aggrieve	agrieved
agitate	aggitate
agree	aggree	agre
agreed	agred
agreeing	agreing
agreement	aggreement
agrees	agress
a hold of	ahold of
airborne	airborn	airbourne
aircraft	aircrafts
airport	aiport
airports	airporta
albeit	albiet
alcohol	alchohol	alchol	alcohal	alochol
alcoholic	alchoholic	alcholic	alcoholical
algorithm	algoritm
algorithms	algoritms
align	allign
alignment	allignment
allege	aledge	alege	alledge
alleged	aledged	aleged	alledged
alleges	aledges	alledges
allegiance	alegience	allegence	allegience
allegory	allagory
alleviate	alliviate
alliance	allaince
allophone	allopone
allophones	allopones
allotted	alotted
all right	allright	alright
allusion, illusion	alusion
alluvial	aluvial
almost	allmost	almsot	alomst
along	allong
already	allready	alreayd
also	allso	alsot	aslo
also, else	alse
altarpiece	alterpiece
although	altho	althought	altough
altogether	alltogether
alumni [plural], alumnus [singular]	alumnis
always	allways	alwasy	alwyas
amass	ammass
amateur	amatuer
ambient	ambiant
amend	ammend
amended	ammended
amendment	admendment	amendmant	ammendment
amenity	ammenity
among	amoung	amung
among, amongst	amonst
amount	ammount
amphitheater	ampitheater
amphitheatre	ampitheatre
Anaheim	Anahiem
anal, annual	anual
analogous	analagous	analogeous
analysis	anaylsis
analytic	analitic
ancestor	ancester
ancestral	ancesteral
ancillary	ancilliary
and	adn	anbd	annd
androgynous	androgenous
androgyny	androgeny
ankle	ankel
annihilate	anihilate
annihilation	anihilation
anniversary	aniversary
announce	annonce	annouce	anounce
announcement	annoncement	annoucement	anouncement
annually	anually
annulled	annuled	anulled
anoint	annoint
anomalies	anomolies
anomalous	anomolous
anomaly	anomoly
anonymity	anonimity
Antarctic	Antartic
anthropologist	anthropolgist
anthropology	anthropolgy
anthropomorphization	anthromorphization
anything	anytying
anywhere	anyhwere
apart	appart
apartment	appartmant	appartment
Apennines	Apenines	Appenines
apologetics	apolegetics
apologies	appologies
apologize	appologize
apology	appology
apparent	aparent	apparant
apparently	aparently	apparantly
appealing, appalling	appealling
appear	apear
appearance	apearance	appearence	apperance
appeared	apeared
appearing	apearing
application	aplication	applicaiton
applications	applicaitons
appoint	apoint
appreciate	appretiate	apprieciate
approach	approch	aproach
approaches	approachs
appropriate	appropiate
approximately	approximatly	approximitely	aproximately
approximation	aproximation
April	april
Aquarius	aquarius
aqueduct	aquaduct
aquifer	aquifier
arbitrarily	arbitarily
arbitrary	abritrary	arbitary
arboretum	arbouretum
archaeology	archaoelogy
archaeology, archeology	archaology
archeologist, archaeologist	archeaologist
archeologists, archaeologists	archeaologists
arches	archs
archetype	archtype
Archiac	archiac
Archimedean	Archimedian
architect	archetect
architects	archetects
architectural	archetectural
architecturally	archetecturally
architecture	archetecture	architechture
Arctic Circle	Artic Circle
Arctic Ocean	Artic Ocean
aren't	arn't
arguably	argubly	argueably	arguebly
argument	arguement
Aries	aries
armature, amateur	amature
arose	arised
around	arround
arranged	aranged
arrangement	arangement	arrangment
arrested, erected	erested
article	artical	artice	articel
artificial	artifical
artificially	artifically
artillery	artillary
ascend	asend
ascertain	acertain
ascetic	asetic
aside	asside
aspects, expects	spects
asphalt	ashphalt
aspirations	asperations
assassin	assasin
assassinate	assasinate
assassinated	assasinated
assassinates	assasinates
assassination	assasination
assassinations	assasinations
assassins	assasins
assault	assualt
assemble	assemple
assertion	assertation
assign	asign
assimilate	asimilate
assistance	assisstance
assistant	assitant
associate	assoicate
associated	asociated	assoicated
associates	assoicates
association	assocation
assume	asume
asterisk	asterick
asteroid	asteriod	astroid
as well	aswell
asymmetric	assymetric
asymmetry	assymetry
atheist	athiest
Athenian	Athenean
Athenians	Atheneans
athlete	athelete
athletic	atheletic
at least	atleast
atmosphere	athmosphere	atomsphere
atone	attone
attach	attatch
attainder, attained	attaindre
attempt	atempt	attemp	attemt	attept
attempted	attemted
attempting	attemting
attend	attent
attendance	attendence
attendant	attendent
attendants	attendents
attend, attended	attened
attitude	atitude	attitide
attorney	attorny
attorneys	attornies
attractions	atractions
attribute	atribute
attributed	atributed
attributes	atributes
audience	audeince	audiance
August	august
Australasia	Australiasia
Australia	austrailia	australia
Australian	australian
author	auther	autor
authoritative	authorative	authoritive
authorities	authorites
authority	autority
autobiographic	authobiographic
autobiography	authobiography
autochthonous	autochtonous	autoctonous
auxiliaries	auxillaries	auxilliaries
auxiliary	auxillary	auxilliary
available	availabe	availiable	avalable	avaliable	avalible
avalanche	avalance
average	averege
averaged	averageed
aviation	avation
away	awya
awesome	awsome
awkward, backward	ackward
awoke	awaked
babies [plural], baby's, babys [French plural]	babys
back	bakc	bcak
background	backround
backpedal	backpeddle
badminton	badmiton	badmitton
bailout	baleout
ballast	ballest
banana	bannana
bandwidth	bandwith
bankruptcy	bankrupcy
bared, bearded, bore, borne	beared
barely	bearly
baron	barron
basically	basicaly	basicly
batch's, batches	batchs
battalion	batallion
beaches	beachs
beaked, broke, broken	breaked
beat, beaten	beated
beautiful	beatiful	beautifull	beautyfull
beautifully	beautifuly
became	bacame	beacame	becamae	becamed
because	beacuse	becasue	becouse	becuase
becoming	becomeing	becomming
before	befoer	befor
begging	beggin
begin, being	beign
beginner	begginer
beginning	beggining	begginning	begining	beginnig
begins	beigns
behavior, behaviour	behavour
Beijing	Bejing
being	bieng
beleaguered	beleagured
Belgium	Belguim
belief	beleif
beliefs, believes	beleives	belives
believable	believeable
believe	beleave	beleive	belive
believer	beliver
bellwether	bellweather
benches	benchs
beneficial	benefical	benificial
beneficiary	beneficary
benefit	benifit
benefits	benifits
bergamot	bergamont
Bernoulli	Bernouilli
besiege	beseige
bestial	beastial
bestiality	beastiality
between	beetwen	betweeen	vetween
bilaterally	bilateraly
binomial, binominal	binominal
bisect, dissect	disect
bit	bited
blame	blaim
blamed	blaimed
blatant	blatent
bled	bleeded
blew, blown	blowed
Blitzkrieg	Blitzkreig
blossom	bloosom	blossem
bona fide	bonafied	bonified
Bonanno	Bonnano
booths, both	boths
bought	buyed
bound	binded
boundaries	boundries
boundary	bondary	boundry
bout, boat, about	boaut
branch's, branches	branchs
Brazilian	Brasillian	Brazillian
breakthrough	breakthough
bred	breeded
brief	breif
briefly	breifly
brilliance	brillance
brilliant	briliant
brilliant [English]; false positives for brillant [French] and Brillant [proper name]	brillant
Britain	Britan	Britian	Brittain
British	Brittish
broadcast	broadcasted	brodcast
broadly	broady
brought	brang	broght	brung
Brussels	Brussells
Buddha	Buddah
building	buiding	buidling	buildng	bulding	buliding
built	builded
bulletin	bulliten
buoyancy	bouyancy
buoyant	bouyant	boyant
bureau	bereau
bureaucracy	beaurocracy
bureaucrat	beaurocrat
burial	burrial
buried	burried
burin, burning, burying, during	buring
business	buisness	busineses	busness	bussines	bussiness
bypass	byepass
cacophonous	cacaphonous
cacophony	cacaphony
Caesar	Ceasar
caffeine	caffiene
caisson	casion
calculate	caluclate	caluculate	calulate
calculated	caluclated	caluculated	calulated
calendar	calander
calendar; calender is correct for the machine	calender
caliber, calibre	calibur
California	Califronia
Californian	Califronian
calligraphy	caligraphy
callous, callus	calous
callused	calloused
calluses	callouses
camaraderie	cameraderie
Cambridge	Cambrige
came back	cameback
camouflage	camoflage
campaign	campain
campaigns	campains
can, cyan	cxan
candidate	candadate	canidate
canister	cannister
canisters	cannisters
canoeing	canoing
canonical	cannonical
cant	cant
capability	caperbility
Cape Town	Capetown
capital	captial
capitalize	captialize
captain	captian
caramel, Carmel-by-the-Sea	carmel
carcass, Caracas	carcas
career	carrear	carreer	carrer
Caribbean	Carribbean	Carribean
caring	careing
Carmelite	Carmalite
carnivorous	carniverous
Carthaginian	Carthagian
cartilage	cartilege	cartilidge
cartographer	carthographer
cartridge	cartrige
cassette	casette	cassete
cassowary	cassawory	cassowarry
casted	casted
casualties	casulaties
casualties; causalities may be correct	causalities
casualty	casulaty
catches	catchs
categories	catagories
categorise	catagorise
categorize	catagorize
category	catagory
caterpillar	catterpilar
caterpillars	catterpilars
catholic	cathlic
Catiline, Catalina	Cataline
Celsius	Celcius
cemeteries	cemetaries
cemetery	cementary	cemetarey	cemetary	cemetry
censor, censure	censur
censure	sensure
census	cencus
centenary, centennial [100 years]	centennary
centennial	centenial
centuries	centruies
century	centruy
ceremonial	cerimonial
ceremonies	cerimonies
ceremonious	cerimonious
ceremony	cerimony
certain, keratin	ceratin
certainty	certainity
cervical, servile, serval	cervial
chairman	chariman
challenge	challange
challenged	challanged
challenger	challanger
Champagne	Champange
changeable	changable
character	carachter	charachter	charater	charcter
characterised [British], characterized [American]	charaterized
characteristics	charistics
characters	charachters
charismatic	carismatic
Charlotte	Charolette
chaser, chase	chasr
chemical	chemcial
chemically	chemcially	chemicaly
chemistry	chemestry
chief	cheif
childbirth	childbird
children	childern
children, children's	childrens
Chinese	Chineese
chocolate	choclate
choice	choise
choosing	chosing
chose, chosen	choosed
chosen	choosen
chronic, chronicle	chronical
church	curch
Cincinnati	Cincinatti	Cincinnatti
circuit	circiut	ciricuit
civilian	civillian
clad	cladded	claded
claims	claimes
classic	clasic
classical	clasical
classically	clasically	classicaly
claustrophobia	claustraphobia
clear	claer
clearance	cleareance	clearence
clearer	claerer
clearly	claerly
clear, sclera	clera
clinical	clincial
clinically	clinicaly
coaches, coaches'	coachs
coast	caost
coerce	coerse
coincide	coinside	concide
coincidence	coinsidence
collaboration	colaboration	collaberation
collateral	colateral
colleague	collegue
colleagues	collegues
collegiate	collegate
colonies	collonies
colonnade	collonade
colony	collony
colossal	collosal
column	collum	collumn
comeback	comback
comercial [Spanish], commercial [English]	comercial
coming	comming
commander, commandeer	comander
commando	comando
commandos	comandos
commemorate	comemmorate	commemmorate	commerate
commemorated	commmemorated
commemorating	commerating
commemoration	commeration
commemorative	commemerative	commerative
commencement	comencement
commerce	comerce
commercial	commerical	commericial
commercially	comercially	commerically	commericially
commission	comision	comission	commision
commissioned	comisioned	comissioned	commisioned
commissioner	comisioner	comissioner	commisioner
commissioning	comisioning	comissioning	commisioning
commissions	comisions	comissions	commisions
commitment	committment
committed	comited	comitted	commited
committee	comittee	commitee	committe	committy
committees	committies
committing	comiting	comitting	commiting
commonly	commongly
communication	communciation
community	comunity
CompAir	compair
comparable	compareable
comparative	comparitive
comparatively	comparitively
compared	compaired
comparison	compairison	comparision	comparsion
compatibilities	compatabilities	compatablities	compatiblities
compatibility	compatability	compatablity	compatiblity
compatible	compatable
compete	compeet
competence	competance
competent	competant	compitent
competing	compeeting
competition, completion	competion
competitive	competative
competitive, completive	competive
competitively	competively
competitor, completor	competor
compile	compilate
compiler	complier
completely	completly
comprehensive	comphrehensive
compromise	comprimise	comprimize	compromize
conceive	concieve
concentrate	consentrate
concentrated	consentrated
concentrates	consentrates
concept	consept
concern	consern
concerned	conserned
concerning	conserning
condemn	condem
condemned	condemed	condemmed
condition	condidtion
conditions	condidtions
conference	conferance	confrence
confidential	confidental
confidentially	confidentally
conform	coform
congratulations	congradulations
congressional	congresional
conjecture	conjecutre
Connecticut	Conneticut
connived	conived
connive, knife	knive
connotation	cannotation
connotations	cannotations
conqueror	conquerer
conquerors	conquerers
conscience	concience
conscientious	concientious
conscious	concious
consciously	conciously
consciousness	conciousness
consecutive	concecutive
consensus	concensus
consent	conscent
conservative	conservitive
conserve	conservate
consider	concider	consdider
considered	concidered	consdidered	considerd
considers	conciders
consistency	consistancy
consistent	consistant
consistently	consistantly
consolidate	consolodate
consolidated	consolodated
consonant	consonent
consonants	consonents
consortium	consorcium
constant	constatn
constantly	constanly
constituencies	consituencies
constituency	consituency
constituent	constituant
constituents	constituants
constitution	consitution	constituion	costitution
constitutional	consitutional	constituional
constraints	constaints
construction	constuction
consummate	consumate
consummated	consumated
contains	containes	countains
contaminate	contaiminate
contemporaneous	contemporaneus
contemporaries	contamporaries
contemporary	contamporary
contention	contension
continuing	continueing
continuous	continous
continuously	continously
contractor	contracter
contributor	contributer
contributors	contributers
control	controll
controlled	contolled	controled
controlling	controling
controls	controlls
controversial	contravercial	contraversial	controvercial	controvertial
controversies	controveries
controversy	contraversy	controvercy	controvery
convenient	conveinent	convienient	convinient
conventional	convential	convetional
conversion	convertion
converted, covered, coveted	coverted
converter	convertor
converters	convertors
convertible	convertable
coolly	cooly
cooperation, corporation	coorperation
coordination	coordiantion
copywrite	copywrite
corporate	corparate	corperate
corporation	corparation	corperation
correspond	corrispond
corresponded	corrisponded
correspondent	correspondant	corrispondant
correspondents	correspondants	corrispondants
corresponding	correponding	correposding	corrisponding
corresponds	corrisponds
corrode	corode
corrosion	corosion
co-star	co-starr
co-starred	co-stared
co-starring	co-staring	co-staring
could, cloud	coudl
could, should, sold	sould
councillor, counselor, counsellor, councilor	councellor
councillors, counselors, counsellors, councilors	councellors
counseling, counselling	counceling	councelling
countries	ocuntries
countries [plural], country's [possessive]	countrys
country	ocuntry
courier, couturier	coururier
court, count; some false positives from C code listings	cout
covenant	convenant
Coventry	Conventry
coy, copy	cpoy
created	creaeted
criterion	critereon
criticise, criticize	critisise	critisize
criticised, criticized	critisized
criticises, criticizes	critisizes
criticising, criticizing	critising	critisizing
criticism	critiscism	critisism
criticisms	critisisms
critics	criticists
crucifixion	crucifiction
cruises	crusies
culminating	culiminating
cumulative	cumulatative
current	curent	currrent
currently	currenly
cut	cutted
dalmatian	dalmation
damage	dammage
Dardanelles	Dardenelles
daughter	daugher	daugter	duaghter
deal, dial, dahl	dael
dealt	dealed
debatable	debateable
decathlon	decathalon
deceive	decieve
decidable	decideable
decide	deside
decidedly	decidely
deciduous	ecidious
decision	descision	dicision
decisions	descisions
decompose	decomposit
decomposed	decomposited
decomposes	decomposits
decomposing	decompositing
decrepit	decrepid
decypher, decipher	decypher
decyphered, deciphered	decyphered
deep-seated	deep-seeded
defendant	defendent
defensive	defencive
defiance	definance
deficit	defecit
define	deffine
defined	deffined
definite	deffinite	definate	definit
definitely	definately	definatly	definetly	definitly
definition	deffinition
degradation	degredation
deities	dieties
deity	diety
demeanor	damenor	demenor
denigrating	denegrating
dependence	dependance
dependency	dependancy
derivative	deriviative
derived	derivated	deriviated	dirived
derived, driven, drove	drived
derogatory	derogitory
descend	decend
descendant	decendant
descendant, descendent	decendent
describe	decribe	discribe
described	discribed
describes	discribes
describing	decribing	discribing
description	discription
desiccated	dessicated
desiccation	dessication
design	desgin
designate	desginate
designed	desgined	dessigned
desirable	desireable	desirible
despair	dispair
desperate, disparate	desparate	disperate
desperately, disparately	desparately
desperation	desparation	despiration
despicable	dispicable
despite	dispite
destroy	destory
destruction	distruction
destructive	distructive
detach	detatch
detached	detatched
detachment	detatchment
detailed	detailled
deterioration	deteriation
determent, deterrent, detriment	determent
determining	determinining
detriment	detrement
detrimental	detremental
devastate	devestate	devistate
devastating	devistating
devastation	devistation
develop	develope
developed	developped
development	developement	developemet	devolopement	devolopment
device	divice
devised, divided	divised
dialogue, dialog	dialouge
didn't	didnt
diesel	diesal
difference	diference
different	diferent	diferrent	differant	differnt	diffrent
difficulties	dificulties
difficulty	dificulty
dilapidated	delapidated
dilate	dialate
dilation	dialation
dimension	dimention
dimensional	dimentional
dimensions	dimenions	dimentions
diminish	deminish
diminution	diminuation	diminuition
diminutive	diminuative	diminuitive
dining room	dinning room
diphtheria	diptheria
diphthong	diphtong	dipthong
diphthongs	diphtongs	dipthongs
directly	direcly	driectly
director	directer
disagreement	dissagreement
disappear	disapear	dissapear	dissappear
disappearance	dissapearance
disappeared	dissapeared
disappearing	dissapearing
disappears	dissappears
disappoint	dissapoint
disappointed	dissapointed	dissappointed
disappointment	dissapointment	dissappointment
disapproval	disaproval
disarray	dissarray
disaster	diaster
disastrous	disasterous
discover	dicover
discovered	dicovered
discovering	dicovering
discovers	dicovers
discovery	dicovery
discrepancy	discrepency
discuss	descuss	dicuss
disease	desease
disenchanted	disenchanged
disintegrated	desintegrated
disintegration	desintegration
disobedience	disobediance	dissobediance	dissobedience
disobedient	disobediant	dissobediant	dissobedient
disoriented	disorientated
disparagingly	disparingly
dispense	dispence
dispensed	dispenced
dispensing	dispencing
disputandum	disputandem
dissatisfaction	disatisfaction
dissatisfied	disatisfied
dissection	disection
dissemination	desimination	disemination
dissolved	disolved
distinction	disctinction
distinctive	disctinctive
distinguish	distingish
distinguished	distingished
distinguishes	distingishes
distributor	distributer
disturb	distrub
disturbed	distrubed
diverse, diverged	diversed
divide	devide
division	devision	divison
divisions	divisons
document	doccument
documented	doccumented
does	doens
does not, doesn't	does'nt	doesnt	dosen't
doing	doign	donig
dominant	dominent	dominiant
do not, don't	do'nt	dont
doubt, daub	doub
dozen	dozend
dramatic	dramtic
drank	drinked
draughtsman	draughtman
Dravidian	Dravadian
drawn, drew	drawed
dream	deram
dreams	dreasm
drink	drnik
drummed	drumed
drummer	drumer
drumming	druming
dryas	dyas
dug	digged
dukedom	dukeship
duly	duely
during	druing	durring
Dwight Yoakam	Dwight Yokam
dyad	diad
dyadic	diadic
dying, dyeing	dieing
dynasty	dinasty
dysfunctional	disfunctional
each other	eachother
early, easily	easly
earring	earing
eclectic	ecclectic	eclectric
eclectic, electric	electic
eclipse	eclispe
economy	ecomony
ecstasy	esctasy
education	eduction
eels	eles
efficiency	effeciency	efficency
efficient	effecient	efficent
effluence	effulence
effort, afford	efford
efforts, affords	effords
egregious	aggregious
eighth	eigth
eked	eeked
ekes	eeks
eking	eeking
elaborate	elaborite
electoral	electorial
electrical	electrial
electrically	electricly
electricity	electricty
electron	electon
electronic	eletronic
elementary	elimentary
elephant	elphant
elicited	elicided
eligibility	eligability
eligible	eligable
eliminated	eleminated
eliminating	eleminating
else	esle
emanant, eminent, immanent, imminent	iminent
emanate	eminate
embankment	enbankment
embarrass	embarass	embarras
embarrassed	embarassed	embarrased
embarrassing	embarassing	embarrasing
embarrassment	embarassment	embarrasment
embezzled	embezelled
emigrant	emmigrant
emigrant, immigrant	imigrant
emigrated	emmigrated
emigrate, immigrate	imigrate
eminent, immanent, imminent	imanent
eminent, imminent	emminent
eminently	emminently
emissaries	emmisaries	emmisarries
emissary	emmisarry	emmisary
emission	emision	emmision	emmission
emission, emotion	emition
emit	emitt
emitted	emited	emmited	emmitted
emitter	emiter
emitting	emiting	emmiting	emmitting
emphasis	empahsis
emphasize	empahsize
emphysema	emphysyma
empiric	imperic
empirical	emperical
empirical, imperial	empirial
empirically	imperically
empiric, empirical, imperial	imperical
enact, intact	inact
encase [verb], in case, incase [obsolete variant of the verb encase]	incase
encryption	encryptiion
encyclopaedia, encyclopedia	encyclopeadia
encypher, encipher	encypher
endeavor, endeavour	endeaver	endevor	endevour
endoliths	endolithes
endurance	endurace	indurance
endure	indure
engineer	engeneer	engieneer	engineeer
engineering	engeneering	engineeering
engineers	engieneers
English, enlist	Enlish
enhancement	enchancement
enlargement	enlargment
enmity	emnity
enormous	enourmous
enormously	enourmously
en route	enroute
ensue	insue
entertaining	intertaining
entice	intice
entities, entitles	entites
entitled	entilted	entited
entrance	entrace
entrepreneur	entrepeneur
entrepreneurial	entrepeneurial
entrepreneurs	entrepeneurs
entrust	intrust
enumerable, innumerable	inumerable
environment	enivoriment	enviorment	enviornment	enviroment
environmental	enviormental	enviornmental	enviromental
environmentalist	enviornmentalist	enviromentalist
environmentally	enviormentally	enviornmentally	enviromentally
environments	enviorments	enviornments	enviroments
episode	epiode	epsiode
epitome	epitomy
equatorial	equitorial
equilibrium	equilibium	equilibrum
equipment	equippment	equiptment
equipped	equiped
equivalent	equivelant	equivelent	equivilant	equivilent
erect	errect
erode	errode
erosion	errosion
erratic	eratic
erratically	eraticly
escape	excape
especially	expecially
essence	esence	essense
essential	esential	essencial	essentual	essesital
established	estalbished
etc.	ect
ethos, those	ethose
euphemism	euphamism
European	Europian	Eurpean	Eurpoean
Europeans	Europians
evaluation, evolution	evalution
every	eveyr
evidently	evidentally
exacerbate	exerbate
exacerbated	exerbated
exaggerate	exagerate	exagerrate
exaggerated	exagerated
exaggerates	exagerates	exagerrates
exaggerating	exagerating	exagerrating
exalted	exhalted
example	exemple	exmaple
exasperated	exasparated
exceed	excede
exceeded	excedded
excel	excell
excellent	excelent	excellant	exelent	exellent
excels	excells
except	exept
excerpt	exerpt
excessive	eccessive
execute	excecute
executed	excecuted
executes	excecutes
executing	excecuting
execution	excecution
exempt	exampt
exercise	excercise	exercice
exerted	extered
exhibit	exibit
exhibition	exibition
exist	exsist
existant [French], existent [English]	existant
existence	existance	exsistance	exsistence
existing	exisiting
exorbitant	exhorbitant
exoskeleton	exoskelaton
expel	expell
expelled	expeled
expelling	expeling
expels	expells
explain	expalin
explanation	explaination
exploit	exploitate
exploitative	exploititive
extension	extention
external	exerternal
extinct, extant	extint
extinguished	extincted
extraordinarily	extrordinarily
extraordinary	extrordinary
extraterrestrial	extraterrestial
extraterrestrials	extraterrestials
extravagant	extravagent
extremely	extremly
extremophile	extremeophile
facetious	fascitious
facilitate	faciliate
Fahrenheit	Farenheit
fallen, fell	falled
falsely	falsley	falsly
falter	faulter
familiar	familar
families	familes
families [plural], family's [possessive]	familys
family	famaly	familiy
famous	famouse
fanaticism	fanatism
farewell	fairwell
fascinate	facinate	fasinate
fascination	facination
fascism	fashism
fashion	fasion
feasibility	feasability
feasible	feasable
February	Febrary	Febuary	Feburary
fed	feeded
feel, field, file, phial	fiel
feels, fields, files, phials	fiels
feet [plural], foot's	feets	foots
felt	feeled
feud	fued
feudal	fuedal
fictional	ficitional	fictonal
fictitious	ficticious	fictious
field	feild
fiery	firey
fifth	fith
filament	filiament
filmmaker	filmaker
filmmaking	filmaking
final	fianl
finally	fianlly	finaly
financially	financialy
find	fidn
first	firt	frist
flagged	flaged
fled, flee, freed	fleed
Flemish	Flemmish
flexibility	flexability
flexible	flexable
flirts, first	firts
florescent, fluorescent	florescent
flourish	fluorish
fluorescent	flourescent
fluoride	floride	flouride
fluorine	flourine
focus	focuse
foliage	foilage
follow	folow
followed	folowed
follower	folower
following	folowing
follow up [verb], follow-up [adjective], followup [noun]	followup
Fomalhaut	Formalhaut
footwear	footware
forbad	forebad
forbade	forebade
forbade, forbidden	forbidded
forbid	forebid
forbidden	forebidden
forceps	foreceps
forebode	forbode
forecast	forcast	forecasted
forecast, forecasted [non-standard past tense or past participle]	forcasted
forecasting	forcasting
foreclose	forclose
foreclosure	forclosure
foregoing [going before], forgoing [going without]	forgoing
forehead	forhead
foreign	foriegn
foreigner	foriegner
foremost	formost
forerunner	for-runner	forrunner	forunner
foresaw	forsaw
foreseeable	forseeable
foreseen	forseen
foresee [see before], Forsee [surname]	forsee
foreshadow	forshadow
foresight	forsight
forest	forrest
forestall	forstall
foretell	fortell
forewarn	forwarn
foreword, forward	foreward	forword
forfeit	forefeit	forefiet	forfiet
forfeiture	forefieture	forfieture
forget	foreget
forgive	foregive
forgo	forego	forgoe
forlese	forelese
forlorn	forelorn
formal	formall
formalize	formallize
formalized	formallized
formally	formaly
format	fromat
former, Fromer [surname]	fromer
formerly	fromerly
formula	forumla
formulate	forumlate
for, of; many false positives	fo
forsake	foresake
forsaken	foresaken
forsook	foresook
forswear	foreswear
for the	forthe
fortunately	fortunatly
forty	fourty
forward	foward
fought	faught	fighted	fougth
found	foudn
foundries	foundaries
foundry	foundary
Franciscan	Fransiscan
Franciscans	Fransiscans
freshman's, freshmen [plural]	freshmans
friend	firend	freind
from	ffrom
from, form	fomr
frontier	fronteir
fulfill	fufill	fullfill
function	funtion
fundamental	fundametal
fundamentals	fundametals
fungi [plural]	funguses
further	furhter	furuther	futher
furthermore	futhermore
futhark, futhorc	futhroc
galactic	galatic
Galatians	Galations
Game Boy	Gameboy	GameBoy
game, Gael, gale	gae
Gandhi	Ghandi
gangster	ganster
garrison	garrision	garrisson
gauge	guage
genealogies	geneologies
genealogy	geneology
general	genaral
generally	generaly
genitalia	genialia
genius	genuis
gentlemen's	gentlemens
Gera"t, great	gerat
German Shepherd	German Shepard
gets	get's
Gibraltar	Gibralter
gilded	guilded
Giulia	Guilia
Giuliani	Guiliani
Giulio	Guilio
Giuseppe	Guiseppe
gives	give's
goddess	godess
goddesses	godesses
Godunov	Godounov
going	goign	gonig
going, Gauguin	gogin
going, ogling	oging
Goodby [surname], goodbye	goodby
good riddance	good riddens
Gothenburg	Gothenberg
Gottlieb	Gottleib
gourd, guard	gaurd
government	goverment	governement	govorment
governmental	govermental	govormental
Government Minister	Government Minster
governor	gouvener	govenor	governer
grabbed	grabed
grabbing	grabing
gradually	gradualy
graffiti	graffitti	grafitti
grammar	grammer
grammatical	gramattical
grammatically	gramatically	grammaticaly
grammatic, grammatical	gramatical
grandchild	granchild
grandchildren	granchildren
granddaughter	grandaughter
grandfather	granfather
grandmother	granmother
grandparent	granparent
grandson	granson
grateful	gratefull	greatful
gratefully	greatfully
gratuitous	gratuitious
great	graet
great, grat [Scottish past tense for greet]	grat
Grecian	Greecian
Greif [surname], grief	greif
grew, grown	growed
group	gropu
grow	grwo
Guadeloupe	Guaduloupe	Guadulupe, Guaduloupe
guanine	gunanine
guarana'	gauarana
guarantee	garantee	gaurantee	gaurentee	guarentee	gurantee
guaranteed	garanteed	gauranteed	gaurenteed	guarenteed	guranteed
guarantees	garantees	gaurantees	gaurentees	guarentees	gurantees
guardian	gaurdian
Guatemala	Guatamala
Guatemalan	Guatamalan
guerilla, guerrilla	guerrila
guerillas, guerrillas	guerrilas
guidance	guidence
guide	giude
Guinness	Guiness
guitarist	guitarrist
guttural	guttaral	gutteral
gyrate	girate
gyrated	girated
gyrates	girates
gyrating	girating
gyration	giration
habeas	habaeus
habeas corpus	habeus corpus
habit	habbit
Habsburg	Habsbourg
had not, hadn't	had'nt	hadnt
half's, halves [plural]	halfs
Halloween	Hallowean
handful	handfull
handled	handeled
happen	ahppen	hapen
happened	hapened	happend	happended
happening	hapening
harass	harras	harrass
harassed	harased	harrased	harrassed	harrasses
harasses	harases	harrases
harassing	harrasing	harrassing
harassment	harasment	harrasment	harrassment
harassments	harasments	harrasments	harrassments
hardware	hardwear
hare	hace
has not, hasn't	has'nt	hasnt
have	ahev	ahve	hvae
have, heave	haev	hvea
having	hvaing
headquarter	headquater
headquartered	headquatered
headquarters	headquaters
heard	heared
heard, Hera, herald	herad
Heidelberg	Heidelburg
height	heighth	heigth	hieght
helpful	helpfull
hemorrhage	hemmorhage
heptathlon	heptathalon
heritage, inheritance	inheritage
herself, himself, themselves	themself
he's, his	hes
heyday	hayday
hierarchical	hierachical	hierarchial	hierarcical
hierarchies	hierachies
hierarchy	heirarchy	hierachy	hierarcy
hieroglyph	hieroglph
hieroglyphics	heiroglyphics
hieroglyphs	hieroglphs
higher	heigher	higer
highest	higest
himself	hismelf
hindrance	hinderence	hindrence
hippopotamus	hipopotamus
hirsute	hersuit	hersute	hirsuit
histocompatibility	histocompatability
hit, hitter	hitted
hitting	hiting
hobbyist	hobbiest
holistic	hollistic	wholistic
holy, wholly	wholy
homepage	hompage
homicide	homocide
homogenize	homogeneize
homogenized	homogeneized
honorable	honarable
honorarium, even in UK	honourarium
honorary	honory
honorary, even in UK	honourary
honorific, even in UK	honourific
horrifying	horrifing
hours, house	housr
however	howver
humoral	humoural
humorous, even in UK	humourous
humorous, humerus	humerous
humour	humer
hundred	hundered
hydrophile	hydropile
hydrophilic	hydropilic
hydrophobe	hydropobe
hydrophobic	hydropobic
hygiene	hygeine	hygene	hygine
hygienic	hygenic
hypocrisy	hypocracy	hypocrasy	hypocricy
hypocrite	hypocrit
hypocrites	hypocrits
iconoclastic	iconclastic
idea	idae
idea, die	diea
ideas	idaes
ideas, ides	idesa
identical	identicial
identify	idenify
identity	idenity
ideologies	idealogies
ideology	idealogy
idiosyncratic	ideosyncratic
illegitimacy	illegimacy
illegitimate	illegitmate
illogical	ilogical
illumination	ilumination
illusion	illution
imaginary	imagenary
imaginary, imagery	imaginery
imagination	immagination
imagine	imagin
imbalance	inbalance
imbalanced	inbalanced
imitate	immitate
imitation	immitation
imitator	immitator
immediate	imediate
immediately	emmediately	immediatelly	immediatley	immediatly	immidately	immidiately
immense	emmense	imense
immigrant	inmigrant
immigrants	inmigrants
immigration	imigration
immunosuppressant	immunosupressant
immutable	immuntable
impasse	impass
impeach	inpeach
impedance	impedence
impede	empede
implement	impliment
impolite	inpolite
important	imporatnt	importan
impound	empound
impoundment	empoundment
impresario	impressario
imprisonment	inprisonment
improvement	improvment
improvisation	improvision
in	iin
inaccessible	inaccessable
inappropriate	inappropiate	inapropriate
inaugurates	inaugures
Incheon	Inchon
inches	inchs
incidentally	incidently
include	inlcude	inlude
including	incuding
incompatibilities	incompatabilities	incompatablities	incompatiblities
incompatibility	incompatability	incompatablity	incompatiblity
incompatible	incompatable
incompetence	incompetance
incompetent	incompetant
inconsistency	inconsistancy
inconsistent	inconsistant
incorporate	encorperate	encorporate	incorperate
incorporation	incorperation
incorruptible	incorruptable
increase	encrease	increse
incredible	increadible	incredable
incumbant	incumbancy
incunabula	incunabla
indefinitely	indefinately	indefinitly
independence	indepedence	independance	independece
independent	indepedent	independant	indipendent	indpendent
independently	indepedantly	independantly	indipendently	indpendently
indict	indite
indispensable	indispensible
indisputable	indisputible
indisputably	indisputibly
indulge	indulgue
industrial	indutrial
inevitable	inevatible	inevitible
in fact	infact
infantry	infanty
infectious	infectuous
infiltrate	infilitrate
infiltrated	infilitrated
infinite	infinit
inflammation	inflamation
influenced	influented
influential	influencial	influental
information	infomation	infomation
in front	infront
ingredients	ingreediants
inhabit	inhabitate
inherent	inherrent
initial	inital	intial	intital
initially	initialy	intially
initiation	initation
initiative	initative	initiatve	inititive	intiative
in lieu	in leiu
in memoriam	in memorium
inner tube	intertube
innocence	inocence
innovation	inovation
innuendo	inuendo
input	inputted
inquirer	inquierer
inseparable	inseperable
insinuate	incinuate
insistence	insistance
insistent	insistant
in spite, inspire	inspite
instance	instatance
instead	instade
institution	insitution
institutions	insitutions
instruction	intruction
insufficient	insufficent
insufficiently	insufficently
insurance	insurence
integral	intergral	intregal	intrical
integrate	intergrate
integrated	intergrated
integration	intergration
intellectual	intelectual
intelligence	inteligence
intelligent	inteligent
interbreed, interbred	interbread
interchangeable	interchangable
interchangeably	interchangably
interest	interst	intrest
interested	intersted
interfere	interfear
interference	interfearance	interferance
interfering	interfearing
interior	interor
intermittent	intermitent	intermittant
international	internation
internment	internment
interpret	interpet	interpretate
interred, interned	intered
interregnum	interrugum
interrelated	interelated
interrupt	interupt	inturrupt
interrupted	interupted
interruptible	interruptable
interruption	interuption
into	inot
introduce	inctroduce	introduct
introduced	inctroduced
intuitive	intutive
intuitively	intutively
inundate	innundate
inundated	innundated
inundation	innundation
inventor	inventer
invertebrate	invertibrate
investor	invester
involvement	involvment
ironically	ironicly
irregular	unregular
irrelevant	irelevent	irrevelant
irresistible	iresistable	iresistible	irresistable
irresistibly	iresistably	iresistibly	irresistably
irritable	iritable
irritate	iritate
is not, isn't	is'nt	isnt
Israel	Isreal
Israeli	Israely
Israelis	Israelies
Ithaca	Ihaca
itinerant	itenerant
itinerant [adjective], itinerate [verb]	itinerate
itself	itsself
it's, its	its's
Japanese	Japaneese	Japanes
jeopardy	jeapardy
jeweler	jewler
jewellery [British], jewelry [American]	jewlery
jewellery, jewelry	jewlrey
Johannine	Johanine
Joseph	Jospeh
journey	journy
journeys	journies
Judaism	Juadaism	Juadism
judicial	judical
judiciary	judisuary
junction	juction	juntion
junior	junoir
just	jstu	jsut
keyboard	keybord
Khalil Gibran	Kahlil Gibran
kilohm	kiloohm
kilohms	kiloohms
kilometer	killometer
kilometre	killometre
kindergarten	kindergarden
knifes [verb]; knives [plural noun]	knifes
know	knwo	konw	nkow	nkwo
knowledge	knowlege
knowledgeable	knowlegeable
knows	knwos	konws
Ku Klux Klan	Klu Klux Klan
labeled [American], labelled [British]	labled
laboratory	labatory	labratory
laborious [even in UK]	labourious
laid	layed
lambda	lamda
language	laguage	langauge	lanugage
languages	laguages
lantern	latern
largely	largley	largly
larvae	lavae
larynx	larnyx
last	lsat
last, latest	lastest
latch's, latches	latchs
lately	lateley	latley
latency	latancy
laterally	lateraly
latitude	lattitude
launch	lauch
launches	launchs
laundromat	laundrymat
lay low	layed low
leaded [gasoline], led	leaded
lead, led	lead
leaf	lief
lean, learn, leaner	leanr
learn	leran
learns	lerans
legislate	ledgislate
legitimate	legitamate
LEGO	Legos
leisure	leasure	liesure
length	lenght
lengthy	lenghty
lens	lense
lent	leant
leukemia	luekemia	lukemia
level	levle
levitate	levetate
levitated	levetated
levitates	levetates
levitating	levetating
lexicon	Lexion
liaison	liason
libel	libell
libel, liable	lible
library	libary
Libya	Lybia
licence	liscence
licence, license	lisence	lisense
license	liscense
lieutenant	leutenant	lieutentant
like	liek	liuke
liked	liekd
likelihood	likelyhood
limit	limitate
linguistic	libguistic
linguistics	libguistics
literal	litteral
literature	litature	literture
Litle [surname], little	litle
little	littel
lively	livley
location	loction
locker room	lockeroom
locomotive	locamotive
locust	locus
loneliness	lonelyness
lonely	lonley
lonely, only	lonly
loosely	loosley	loosly
Los Angeles	Los Angles
lose, loose [release]	loose
losing	loseing
losing, loosing [releasing]	loosing
Louisiana	Lousiana
love	loev	lveo	lvoe
lovely	lovley
luckily	luckly
lunches	"lunchs"
lying	lieing
mackerel	mackeral
magically	magicaly
magnetic	magentic
magnolia	magolia
maintenance	maintainance	maintainence	maintance	maintence	maintenence
majestic	magestic
majority	marjority
majuscule	majiscule
make	amke	mkae	mkea
makes	makse	mkaes
making	amking	makeing	mkaing
Malcolm	Malcom
Maltese	maltesian
mammal	mamal
mammalian	mamalian
manageable, manageably	managable
management	managment	mangement
mandatory	manditory
maneuverability, manoeuvrability	manoeuverability	manouverability
maneuverable, manoeuvrable	manouverable
maneuver, manoeuvre	manouver	manuever
maneuvers, manoeuvres	manouvers	manuevers
Manhattan	Manhatten
manifest	mainfest
manufacture	manufature
manufactured	manufatured
manufacturing	manufaturing
marked, made	maked
marketing	marketting
marriage	marrage	marraige	marrige
married	marryed	marryied
Marxist	Marixist
Massachusetts	Massachussets	Massachussetts
mass media	massmedia
masturbation	masterbation
matches	matchs
mathematician	mathmatician
mathematicians	matheticians	mathmaticians
mathematics	mathamatics
maybe	mabye
mayoral	mayorial
meaningful	meaningfull
mechanism	mechanisim
medicine	medacine
mediciny	mediciney
medieval, mediaeval	medeival	medievel	medival
Mediterranean	Mediteranean
meerkat	meerkrat
megohm	megaohm
megohms	megaohms
member	memeber
membranophone	membranaphone
mentioned	maintioned
merely	mearly
messenger	messanger
metallic	metalic
metallurgic	metalurgic
metallurgical	metalurgical
metallurgy	metalurgy
metamorphosis	metamorphysis
meteorology	meterology
Michael	Micheal
Michigan	Michagan	Michgian
midwives	midwifes
milieu	mileau	mileu
military	millitary	miltary
millennia	milennia	millenia
millennium	milennium	millenium
million	milion
millipede	millepede
miniature	minature	miniture
mining	minning
ministry	ministery
Minnesota; Minesota Mine [in Michigan] is correct	Minesota
minuscule	miniscule
miracle	miricle
miscellaneous	miscelaneous	miscellanious	miscellanous
mischievous	mischeivous	mischevious	mischievious
misdemeanor	misdameanor	misdemenor
misdemeanors	misdameanors	misdemenors
misogynist	mysogynist
misogyny	mysogyny
missile	misile	missle
Mississippi	Missisipi	Missisippi	Mississipi
Missouri	Misouri
misspell	mispell
misspelled	mispelled
misspelling	mispelling
Mithraic	Mythraic
mixed	mixted
mizzen	missen
model	modle
mohel	moil
molest	mollest
moment	moent
monasteries	monestaries
monastery	monastry
monastery, monetary	monestary
money	moeny
monitor	moniter
monolithic	monolite
monotypic	montypic
Montserrat	Monserrat
more	mroe	omre
more so	moreso
Morissette	Morisette	Morrisette
mortgage	morgage
motivated	motiviated
movie	movei
mucous	mucuous
municipalities	muncipalities	municipalties
municipality	muncipality	municipalty
murder	muder
murderer	muderer
murdering	mudering
mussels, muscles	muscels
myriad	miriad	myraid
myself	mysef
mysterious	misterious	misteryous	mysterous
mystery	mistery
Napoleonic	Napoleonian
nasalisation	ansalisation
nasalization	ansalization
nascent	nacent	nascient
natural	natrual	naturual
naturally	natuarlly	naturaly	naturely	naturually
Nazareth	Nazereth
necessarily	neccesarily	neccessarily	necesarily	nessasarily
necessary	neccesary	neccessary	necesary	nessacary	nessecary
need	ened
negative	negitive
negativity	negitivity
negligible	neglible	negligable
negotiate	negociate
negotiation	negociation	negotation
neighbourhood	nieghborhood
neighbouring, neighboring	neigbouring
neighbour, neighbor	neigbor	neigbour	neighboor
neighbours, neighbors	neigbours
neutral	nuetral
Newfoundland	Foundland
newly	newely
New Yorker	Newyorker
next	enxt
Niagara Falls	Niagra Falls
niche	nitch
niece, nice	neice
nineteen	ninteen
nineteenth	ninteenth
ninety	ninty
ninth	nineth
ninthly	ninethly
nitpick	knitpick
nonexistent	non-existant
no one	noone
north	noth
northeastern	northereastern
northern	northen	nothern
not	nto
notable	noteable
notably	noteably
note, not	onot
noteworthy	notewothy
noticeable	noticable	noticible
noticeably	noticably
noticing	noticeing
notoriety	nortoriety	notariety	noteriety
notorious	nortorious	notorius
nouveau	noveau
nowadays	now adays	nowdays
nuclear	nucular	nuculear
nuisance	nuisanse	nusance
Nullarbor	Nullabour
nuptial	nuptual
Nuremberg	Nuremburg
nutrient	nutritent
nutrients	nutritents
obedience	obediance
obedient	obediant
observance	observence
observation	obervation
obsolescence	obsolecence	obsolecense	obsolesence	obsolesense
obsolete variant of encased	incased
obstacle	obstacal	obsticle
occasion	ocasion	ocassion	occassion
occasional	ocasional	ocassional	occassional
occasionally	ocasionally	ocasionaly	ocassionally	occassionally	occassionaly
occasioned	ocasioned	ocassioned	occassioned
occasions	ocasions	ocassions	occassions
occupied	ocupied
occur	occurr	ocurr
occurred	occured	ocurred
occurrence	occurance	occurence	occurrance	ocurrance	ocurrence
occurrences	occurances	occurences	occurrances
occurring	occuring
octahedra	octohedra
octahedral	octohedral
octahedron	octohedron
odoriferous, even in UK	odouriferous
odorous, even in UK	odourous
official	offcial	offical
officially	offically	officaly	officialy
offshoot	offshot
often	oftenly
of the	ofthe
omission	omision	ommision
omitted	omited	ommited	ommitted
omitting	omiting	ommiting	ommitting
omnivorous	omniverous
omnivorously	omniverously
only	onyl
on the	onthe
opened	oppened
opening	oppening
operate	opperate
operation	opperation
ophthalmic	opthalmic
ophthalmologist	opthalmologist	opthamologist	opthomologist
ophthalmology	opthalmology	opthamology	opthomology
opinion	oppinion
opponent	oponent
opportunity	oportunity	oppertunity
opposite	oposite
opposition	oposition
oppression	opression
oppressive	opressive
optimism	optomism
optimist	optomist
optimistic	optomistic
orally, really	erally
organise	orginize
organism	organim
orient	orientate
oriented	orientated
original	orginal	originnal	origional	orignal	origonal
originally	orginally	originaly	originnally
originate	orginate
origin, organ	orgin
orthogonal	orthagonal
orthogonally	orthagonally
other	otehr
out loud	ouevre
output	outputted
overlaid	overlayed
overshadowed	overshaddowed
overwhelming	overwelming
own	pwn
oxen [plural] or oxen's	oxens
oxygen	oxigen	oxyen
oxymoron	oximoron
paced, passed	pased
paid	paide	payed
palace	palce
Palestinian	Palistian	Palistinian
Palestinians	Palistinians
palette	pallete
pamphlet	pamflet	pamplet
panicking	panicing
panorama	panarama
pantomime	pantomine
Papanicolaou	Papanicalou
paparazzi	paparazzis
parakeets	parrakeets
parallel	paralel	paralell	parallell	parralel	parrallel	parrallell
parallelly	paralelly	paralely	parallely	parrallelly	parrallely
parameter	perameter
paraphernalia	paraphenalia
parenthesis	paranthesis
parliament	parliment
parliamentarian	paliamentarian
parsable	parseable
partially	partialy
participant	particpant
participate	partecipate
participated	particpated
particular	parituclar
particularly	particularily
partition, portion	partion
passenger	pasenger	passanger
pasted	pasted
pasteurize	pasturize
pastime	passtime	pasttime
pastoral	pastorial	pastural
patent	pattent
patented	pattented
pavilion	pavillion
peaches	peachs
peculiar	peculure
pejorative	perjorative
Peloponnese	Peloponnes
peloton	peleton
penalty	penatly
peninsula	peninnsula	penisula	penninsula	pennisula	pensinsula
peninsular	penisular	penninsular
Pennsylvania	Pennsilvania	Pensylvania
people	peopel
perceive	percieve
perceived	percepted
perform	peform
performance	peformance	performence
performed, performs	performes
perhaps	perhasp	perheaps	perhpas	perphas
peripatetic	peripathetic
perjury	perjery
permanent	permanant	permenant
permissible	permissable
permission	premission
permit	permitt
permitted	permited
permitting	permiting
perpendicular	perpindicular
per se	persay
perseverance	perserverance	perserverence	perseverence
perseverant	perseverent
persevere	perservere
persistence	persistance
persistent	persistant
personal, personnel	personel
personnel	personell	personnell
persuade	pursuade
perturbation	pertubation
perturbations	pertubations
pessary	pessiary
petition	petetion
Pharaoh	Pharoah
phenomena	phenonmena
phenomenal	phenomenonal	phenominal
phenomenally	phenomenonly
phenomenon	phenomonenon
pheromone	feromone
Philadelphia	Philadephia	Philedelphia
Philippine	Phillipine	Phillippine
Philippines	Philipines	Phillipines	Phillippines
philosopher	philisopher
philosophical	philisophical
philosophy	philisophy
Phoenician	Phonecian
Phoenix	Pheonix
phonetic	fonetic
phonograph	phongraph
physical	fysical
piece	peice
pigeon	pidgeon
pilgrimage	pilgrimmage
pineapple	pinapple	pinnaple
pitch	pich
plagiarism	plagarism
plaintiff	plantiff
planned	planed
played	palyed
played, plied	plyed
player	palyer
playing	palying
playwright	playright	playwrite
playwrights	playwrites
pleasant	pleasnat	plesant
plebiscite	plebicite
plethora	plethura
poem	peom
poetry	peotry
pogrom	progrom
poinsettia	poinsetta
poison	poisin
Poke'mon	pokemon
pollination	polination
pollinator	polinator
pollinators	polinators
pollute	polute
pollution	polution
polysaccharide	polysaccaride	polysaccharid
pomegranate	pomegranite
poor, Poore [surname]	poore
popularity	popularaty
population	populaion
portrait	protrait
portray	protray
portrayal	protrayal
portrayed	protrayed
Portuguese	Portugese
position	possition	postion
position, positron	positon
possess	posess
possessed	posessed
possesses	posesses	posseses
possessing	posessing	possesing
possession	posession	possesion
possibility	possibilty
possible	possable
possibly	possably
potatoes	potatos
Potsdam	Postdam
power	pwoer
powerful	powerfull
practical	practial
practically	practially	practicaly	practicly
practice	pratice
practitioner	practicioner	practioner
practitioners	practicioners	practioners
prairie	prairy	prarie
preamble	preample
precede	preceed
preceded	preceeded
precedes	preceeds
preceding	preceeding
pre-Columbian	pre-Colombian
precursor	precurser
predecessor	precedessor
predominantly	predominately
preexistent	pre-existant
prefer	preferr	preffer
preferably	preferrably
preferred	prefered	preffered
preferring	prefering
pregnancies	pregancies
pregnancy	pregancy
premiere	premeir
premiered	premeired
premier, premiere	premeire
premillennial	premillenial
Premonstratensians	Premonasterians
preparation	prepartion	preperation
preparatory	prepatory	preperatory
prepare	perpare	prepair
prerogative	perogative
presence	presense
presidential	presidental
pressure	presure
prestigious	prestigeous	prestigous
presumably	presumibly
prevalence	prevelance
prevalent	prevelant
prevention	preventation
previous	previvous
primarily	primarly
Prime Minister	Prime Minster
primitive	primative
primitively	primatively
primitives	primatives
primordial	primordal
Princeton	Princton
principal	pricipal	principial	prinicipal
principally	principly
principle	priciple
Priscilla	Pricilla
prison	prision
privately	privatly
privilege	priveledge	privelege	privelige	privilage	priviledge	privledge
privileged	priveleged	priveliged
privileges	priveledges	priveleges	priveliges	priviledges
probability	probalibity
probably	probablly	probaly	propably
problem	probelm
procedure	procedger	proceedure
proceeding, preceding	proceding
proceed, precede	procede
proceeds, precedes	procedes
process	proccess
proclaim	proclame
proclamation	proclomation
profession	proffesion
professor	profesor	proffesor
profusion, profession	profesion
programmable	programable
programmer	programer
program, programme	programe
prohibition	prohabition
prolegomena	prologomena
prolific	profilic
prominence	prominance
prominent	prominant	prominate
prominently, predominately	prominately
promiscuous	promiscous
pronominal	pronomial
pronunciation	pronounciation
propaganda	propoganda
propagate	propogate
propagation	propogation
propagator	propogator
propel	propell
propelled	propeled
propelling	propeling
proper, Propper [surname]	propper
prophecy	prophacy
proportion	propotion
proportional	propotional
proprietary	propietary	proprietory
proselytizing	proseletyzing
protagonist	protaganist
protein	protien
pro tem, protein	protem
protocol	protocal
protuberance	protruberance
protuberances	protruberances
provided	provded
provider	providor
pseudo	psuedo
pseudonym	pseudonyn
pseudonymous	pseudononymous
psychic	psyhic	pyschic
psychology	psycology	pyschology
public, publish	publich
Puccini	Pucini
Puerto Rican	Puertorrican
Puerto Ricans	Puertorricans
pumpkin	pumkin
purposely	purposedly
pursue	persue
pursuing	persuing
pursuit	persuit
putting	puting
quandary	quandry
quantity	quanity	quantaty
quarantine	quarantaine
quarter	quater
quarterback	quaterback
quarterfinal	quater-final
quarterly	quaterly
quartermaster	quatermaster
quaternary	quarternary
quickly	quicklyu
quietly	quitely
quit	quitted
quite, quiet	qtuie	qutie
quizzes	quizes
quote	qoute
quoted	qouted
quotes	qoutes
rabbinical	rabinnical
raised, risen, rose	rised
ramification	rammification
rancorous, even in UK	rancourous
rarely	rarley
ratify	radify
real	rela
realised, realized	relized
realization	relization
realize	relize
really	raelly	realy	realyl	relaly
realm	relm
reassess	reasses
rebroadcast	rebroadcasted
rebuttal	rebuttle
recall	reacll
recast	recasted
recede	receed
receded	receeded
receding	receeding
receipt	reciept
receive	recieve
received	recepted	recieved
receiver	reciever
receives	recieves
receiving	recieving
recent	reccent
recipes	recepies	recipies
recipient	recepient	recipiant
recklessness	wrecklessness
recognise	recogise
recognize	recogize
recommend	reccomend	reccommend	recomend
recommended	reccomended	reccommended	recomended
recommending	recomending
recommends	recomends
reconcile	reconciliate
reconciliation	reconcilation
reconnaissance	reconaissance	reconnaissence
record	recrod
recorded	recoreded
recoup	recoupe
recreational	recrational
recruited	recruted
recuperate	recouperate
recur	recurr
recurrence	recurrance
recurrent	recurrant
recurring	reccuring	recuring
redevelopment	redevelopement
redundant	redundent
reevaluated	revaluated
reference	referrence	refference	refrence
referral	referal
referred	refered	reffered
referring	refering
refers	referrs
refrigeration	refridgeration
refrigerator	refridgerator
refusal	refusla
regard	reguard
regardless	irregardless
registry	registery
regular	regluar
regularly	reguarly	regularily
rehearsal	rehersal
related	realted
relating	realting
relationship	relatiopnship
relative	realtive
relatively	relativly	relitively
release	realease
relegate	relagate
relegated	relagated
relevance	relevence	revelance
relevant	relavent	relevent	revelant
reliability	reliablity
relieve	releive
relieved	releived
religion	religon
religious	religeous	religous
remain	reamain	reamin	remian
remained, renamed	remaned
remaining	remaing	remainging	remaning
remember	rember	remeber
remembrance	rememberance	remembrence
reminiscent	reminescent	reminicent
remnant	reminant	reminent
rendezvous	rendevous
renovate	rennovate
renovation	rennovation
renowned	reknowned	renouned
renown, renowned	reknown
repaid	repayed
repentance	repentence
repentant	repentent
repertoire	repetoire
repetition	repetion	repitition
repetition, repartition	repatition
repetitive	repeative
representative	representive
representatives	representives
reprise	reprize
republic	repubic
require	recquire
re-released	re-realeased
rescue	rescure
research	reasearch
resemblance	resemblence	ressemblance	ressemblence
resemble	ressemble
resembled	ressembled
resembling	ressembling
reservoir	reservor	resevoir
reset	resetted
reside	recide
residence	residance
resident	recident
residents	recidents
resignment	resignement
resistance	resistence
resistant	resistent
resistible	resistable
response	reponse	responce
responsibility	responibility	responnsibilty	responsability	responsibilty	resposibility
responsible	reponsible	responsable	resposible
restaurant	restarant	restaraunt	restauraunt	resteraunt	restrant	restuarant	resturant
restaurants	restaraunts	resteraunts
restaurateur	restaraunteur
restaurateurs	restaraunteurs
restoration	restauration
restraint, restaurant	restraunt
resurgence	resurgance
resurrect	resurect
resurrecting	resurecting
resurrection	ressurection
retaliate	retailate
retaliated	retalitated
retaliation	retailation	retalitation
retrieved	retreived
returned	retured
returning	retruning	returing
reverence	reverance
reverend	reverand
reverent	reverant
reversible	reversable
revolutionary	revolutionar
rewrite	rewriet
rhyme	rhymme
rhythm	rhythem	rhythim	rhythym	rhytm	rythem	rythim	rythm	rythym
riches	richs
RIDGID	ridgid
ridicule	redicule
ridiculous	rediculous
rigorous	rigourous
rigour	rigeur
ringing	rininging
Rockefeller	Rockerfeller
rococo	rococco
roommate	roomate
roughly	rougly
rule	rulle
running	runing
Russian	Rusian	Russina	Russion
sacrifice	sacrafice
sacrilegious	sacreligious
safeguard	safegaurd
safely	safetly
safety	saftey	safty
salaries	saleries
salary	salery
same	smae
San Bernadino [song], San Bernardino [California]	San Bernadino
San Diego	San Deigo
sandwich	sandwhich
San Francisco	San Franciso	San Fransico	San Fransisco
Sanhedrin	Sanhedrim
sank, sunk	sinked
satellite	satelite	sattelite
satellites	satelites	sattelites
satiric	satric
satirical	satrical
satirically	satrically
Saturday	Saterday
Saturdays	Saterdays
satyr, story	sotyr
savvy	savy
saxophone	saxaphone
says	syas
says, sassy	sasy
scalable	scaleable
Scandinavia	Scandanavia
Scandinavian	Scandanavian
scenario	scenerio
schedule	schedual
scholastic, scholarly	scholarstic
scissors	sissors
Scotland	Scottland
script	scirpt
scroll	scoll
sculpture	scupture
seamless	seemless
search	seach	serach
searched	seached
searches	seaches	searchs
seceded, succeeded	secceeded
secession	seccesion
secondary	secondry
secret	secrect
secretary	secratary	secretery
sedentary	sedantary
seemingly	seamingly
See's [company], sees [verb]	see's
seismic	siesmic
seized, sized	siezed
seize, size	sieze
seizing, sizing	siezing
seizure	siezure
seizures	siezures
selection	selction
senior	senoir
sense	sence
separate	seperable
separating	seperating
separation	seperation
separatism	seperatism
separatist	seperatist
sepulchre, sepulcher	sepulchure	sepulcre
sequel	sequal
sergeant	sargant	sargent
series	serieses
series, series', series's	serie's
servant	servent
set, settled	setted
several	severeal	sevral
severely	severley	severly
shadow	shaddow
shaman, shamans	shamen
sheath, sheet, cheat	sheat
sheep	sheeps
sheriff	sherif
shield	sheild
shining	shineing
shipped	shiped
shipping	shiping
shoo-in	shoe-in
shot	shooted
should	shoud	shoudl
should not, shouldn't	should'nt	shouldnt
should, shouldn't	shoudln
show	sohw
shrewd	shrewed
shriek	shreak
sidereal	sedereal	sideral
siege	seige
signatories	signitories
signatory	signitory
signature	signiture
signed, singed, singled	singed
significance	signifigance
significant	signifigant
significantly	signifantly	significently
similar	similair	similiar	simmilar	simular
similarity	similiarity
similarly	similarily	simmilarly
simpler	simplier
simply	simpley
simulcast	simulcasted
simultaneous	simultanous
since	sicne
sincerely	sincerley
sines, since	sinse
single-handedly	single-handily
singsong	singsog
Sistine	Sixtin
Skagerrak	Skagerak
skilful [British]	skilfull
skillful [American]	skillfull
sleeve	sleave
slid	slided
smooth	smoothe
smooths	smoothes
sneaked	snuck
sneeze	snese
snorkel	snorkle
software	sofware
soldier	solider
solely	soley	souly
soliloquy	soliliquy
solitary	solatary
soluble	soluable
some	smoe	soem
sophisticated	sophicated	suphisticated
sophomore	sophmore
sorcerer	sorceror
sought	saught	seeked
sound	soudn
sounds	soudns
soup	suop
south	sourth
southeast	southheast
southern	sourthern
souvenir	souvenier
souvenirs	souveniers
sovereign	soverign
sovereignty	sovereignity	soverignity
spaghetti	spagetti
Spanish	spainish
spare, sparse	sparce
sparsely	sparsly
special	speical
specialised [British], specialized [American]	speciallized
specialty	speciality
specificity	specifity
specific, specify	specif
specimen	speciman
spectacular	spectauclar
speech	speach
spermatozoa	spermatazoa
spiritual	spritual
split	splitted
spoke, spoken	speaked
sponsor	sponser
sponsored	sponzored
spontaneous	spontanious	spontanous
sports car	sportscar
spread	spreaded
spun off	spunoff
staring, starring	staring
start, strata	strat
statement	statment
statutory	statuatory
stepped	steped
steroid	steriod
stole	stealed	stoled
stop	stpo
stopped	stoped
stopping	stoping
storeys	storys
stories	storeis	storise
story	sotry	stopry	stoyr
story, destroy	stroy
straitjacket	straightjacket
strand	strnad
strange	stange
strategic	startegic
strategies	startegies	stradegies
strategy	startegy	stradegy
strength	strenght
strengthen	strenghen	strenghten
strengthened	strenghened	strenghtened
strengthening	strenghening	strenghtening
strenuous	strenous
strictest	strictist
stringent	stingent
strong	storng
strongest	stornegst
struck	striked
structural	structual
structure	structer	structue	stucture
structured	stuctured
stubbornness	stubborness
study	studdy
studying	studing
stunk	stinked
stylus	stilus
subcategories	subcatagories
subcategory	subcatagory
submit	submitt
submitted	submited
submitting	submiting
subpoena	sepina
subsequent	subesquent	subsquent
subsidiary	subsidary	subsiduary
substance	substace
substantial	substatial
substantially	substantually
substitute	subsitute
subterranean	subterranian
subtly	subtlely	subtley
subtract	substract
subtracted	substracted
subtraction	substraction
subtracts	substracts
suburb, superb	suberb
succeed	succede	suceed
succeeded	suceeded
succeeded, seceded	seceeded
succeeding	suceeding
succeeds	suceeds
succeed, secede	seceed
success	succes	sucess
successes	sucesses
successful	succesful	succesfull	successfull	sucesful	sucessfull
successfully	succesfully	succesfuly	sucesfully	sucesfuly	sucessfully	sucessfuly
succession	succesion	sucesion	sucession
successive	succesive	sucessive
succinct	succint
sufficient	suffcient	sufficent
sufficiently	suffciently	sufficently
suffrage	sufferage
suicide	sucide
summary	sumary
superintendent	superintendant
supersede	supercede	superceed	superseed
superseded	superceeded
supersession	supercession
supersessionism	supercessionism
supplant	suplant
supplanted	surplanted
supplement	suplement	supplament	suppliment
supplemental	suplemental
support	wupport
suppose	supose
supposed	suposed	suppossed
supposedly	suposedly	supposably
supposes	suposes
supposing	suposing
suppress	supress	surpress
suppressed	supressed	surpressed
suppresses	supresses
suppressing	supressing
supremacist	supremist
surely	surelly
surly, surely	surley
surprise	suprise	suprize	surprize
surprised	suprised	suprized	surprized
surprising	suprising	suprizing	surprizing
surprisingly	suprisingly	suprizingly	surprizingly
surrender	surender
surrendering	surrundering
surreptitious	surrepetitious	surreptious
surreptitiously	surrepetitiously	surreptiously
surround	suround
surrounded	surounded
surrounded, surrendered	surrended
surrounds	surounds
surveil	surveill
surveyor	surveyer
survivor	surviver
survivors	survivers
susceptible	suceptible	suseptible
swam	swimmed
swear	swaer
swears	swaers
Sweden	Sweeden
Swedish	Sweedish
swept	sweeped	sweept
swimming	swiming
switches	switchs
symbolic	symbolical
symmetric	symetric	symmetral
symmetrically	symetrically	symmetricaly
symmetric, symmetrical	symetrical
symmetry	symetry
synonymous	synonomous
syphilis	syphillis	syphyllis
syrup	syrap
system	sytem
taillight	tailight
take	tkae
taken	tooked
taken, took	taked
takes	tkaes
taking	tkaing
talked	talekd
talking	tlaking
tambourine	tamborine
tariff	tarriff
taste	tast
tattoo	tatoo
tattoos	tattooes
taught	teached
taught, thought, tough	tought
taxonomic	taxanomic
taxonomy	taxanomy
teaches	teachs
teammate	teamate
teared [eyes], tore, torn	teared
technician	techician
technicians	techicians
technology	technolgy	tecnology
televise	televize
temperament	temperment
temperamental	tempermental
temperate	temparate
temperature	temperture
tenant	tennant
tendency	tendancy
tennis player	tennisplayer
tentacle	tenacle
tentacles	tenacles
tenuous	tenous
tenure	tenture
terrestrial	terrestial
territories	terriories
territory	teritory	terriory	territority
terrorist	territorist
testament	testiment	testimont
testicle	testical
testimonial	testamonial
testimony	testamony
than	tahn	thna
that	taht	tath	thgat	tht	thta	thyat	tyhat
that, that's	thast
the	teh	tghe	thge	thte	tje	tjhe	yhe
theater, theatre	theather
their	theri	thier
themselves	themselfs
then	thne
then, hen, the	hten
theologian	theologan
theoretical	theroretical
therefore	therfore
there, here	htere
there, their, the	ther
these	theese
the, they	tyhe
they	htey	tehy	thay
thief	theif
thief [noun], thieve [verb]	thieve
thieves	theives	thiefs
thing	hting	thign	thnig
things	thigsn	thnigs
think	htikn	htink	thikn	thiunk	tihkn
thinking	thingking
thinking, thickening	thikning
thinks	thikns
third	thrid
this	htis	thsi	tihs
thoroughly	thouroughly	throughly
those	thsoe
thought, through, throughout	throught
threat	threath
three	threee
threshold	threshhold	treshold
through	thru
throughout	throughtout	througout
thrust	thrusted
Tijuana	Tiajuana
time	timne
time, Tim	tiem
time, tome	tiome
tobacco	tabacco	tobbaco
today	todya
today's, todays [plural]	todays
tolerance	tolerence
tolerant	tolerent
Tolkien	Tolkein
tomatoes	tomatos
tomorrow	tommorow	tommorrow
tongue	tounge
tonight	tongiht
took over	tookover
torch, touch	tourch
toroidal	toriodal
torpedoes	torpedos
to the	tothe
tournament	tornament	tourmanent
toward	towrad
town	twon
traditionally	traditionaly
traffic [English], trafic [French]	trafic
trafficked	trafficed
tragedy	tradgedy
training	traning
transcend	trancend
transcended	trancended
transcendence	transcendance
transcendent	trancendent	transcendant
transcendental	trancendental	transcendentational
transcending	trancending	transending
transcribing, transcription	transcripting
transept	transcept
transfer	transferr
transferred	transfered
transferring	transfering
transform	tranform
transistor	transister
transition	transistion
translator	translater
translators	translaters
transmissible	transmissable
transmit	transmitt
transmitted	transmited
transmitter	transmiter
transportation	transporation
tremolo	tremelo
triathlon	triathalon
tried	tryed
tries	trys
trilogy	triology
trod, trodden	treaded
troupes, troops	troups
truly	truely	truley
trustworthiness	trustworthyness
Tucson [Arizona], Tuscan [of Tuscany]	Tuscon
Tuesday	Teusday
tumultuous	tumultous
Turkey	Turky
turkeys	turkies
turnkey, trunk	turnk
twelfth	twelth	twelveth
twenties	twentys
type-cast	type-casted
typical	tipical	typcial
typically	typicaly
tyranny	tyrany	tyrrany
ubiquitous	ubiquitious
Ukraine	Ukrane
Ukrainian	Ukranian
ultimate	ulitmate
ultimately	ultimatly
unabated	unabatted
unaffected	uneffected
uncertainty	uncertainity
unconscious	unconcious
unconsciousness	unconciousness
unconventional	unconvential
undecidable	undecideable
underdevelopment	undevelopment
underlaid	underlayed
underlie	underly
underlying	underlaying
underrated	underated
underwear	underware
unemployment	unnemployment
unfazed	unphased
unforeseen	unforseen
unfortunately	unforetunately	unfortunatly
unilateral	unilatreal
unilaterally	unilatreally
United Kingdom	United Kingdon
United States	United Stats	Unites States	Untied States
universities	univeristies	univerities	universties	univesities	unviersities
university	univeristy	univerity	universty	univesity	unviersity
unmaneuverable, unmanoeuvrable	unmanouverable
unmistakably	unmistakeably
unnecessarily	unneccesarily	unneccessarily	unnecesarily
unnecessary	unecessary	unneccesary	unneccessary	unnecesary
unnoticeable	unoticeable
unofficial	unoffical
unpleasant	unplesant
unrepentant	unrepentent
unsubstantiated	unsubstanciated
unsuccessful	unsuccesful	unsuccessfull	unsucesful	unsucessfull
unsuccessfully	unsucesfuly	unsucessfully
unsurprised	unsuprised	unsuprized	unsurprized
unsurprising	unsuprising	unsuprizing	unsurprizing
unsurprisingly	unsuprisingly	unsuprizingly	unsurprizingly
until	untill
unto, up to	upto
untranslatable	untranslateable
unusually	unusualy
unwieldily [adverb], unwieldly [British], unwieldy [American]	unwieldly
unwieldy	unweildly
upon, apron	apon
usage	useage
use	uise
used, unused, unsaid	unsed
used, utilised [Brit], utilized [Amer]	utilisied	utilizied
useful	usefull
usefully	usefuly
using	useing
usually	usally	usualy
usurp	usurpate
utmost [greatest, ultimate], acceptable variant of uppermost	upmost
vacuum	vaccum	vaccume	vacume
valuable	valuble	valueable
variant, Varient [corporate name]	varient
varieties	varities
variety, Varity [corporate name]	varity
various	varous
varsity	varisty
vassal	vasall
vassals	vasalls
vegetable	vegitable	vegtable
vegetarian	vegatarian	vegitarian
Venezuela	Venezuala
vengeance	vengance	vengence
venomous	venemous
veranda, Miranda	meranda
verbiage	verbage
verification	verfication
verisimilitude	versimilitude
versatile	versitile
version, Verizon [corporate name]	verison
very	veyr	vrey	vyer	vyre
veteran	vetran
veterinary	vetinary
vicinity	vacinity	vincinity
vigilance	vigilence
vigilant	vigilent
vigorous	vigourous
vigueur, vigour, vigor	vigeur
vilified	villified
vilify	villify
village	vilage
villain	villian
villi, villain, villein	villin
violent	voilent
Virginia, Virgin	Virgina
viri [Latin], viruses	viri
viruses	virii
visibility	visability
visible	visable
visibly	visably
visitation	vistation
visiting	visting
visit, vista, Vist [proper noun]	vist
volcano	volcanoe
volition	volation
Volkswagen	Volkswagon
voluntary	volontary
volunteer	volonteer	volounteer
volunteered	volonteered	volounteered
volunteering	volonteering	volounteering
want	watn	whant	wnat
wanted	wnated
wants	want's	whants	wnats
want to	wanna
warrant	warrent
was	wass	ws
was not, wasn't	was'nt
wasn't	wasnt
watches	watchs
weakened	weakend
weaponry	weaponary
wear, mere, mare	mear
weather, whether	wheather
weather, whether, wether [sheep]	wether
webcast	webcasted
website	webstie	wesbite
Wednesday	wendsay	wendsday	wensday
weird	wierd
went	whent
were, we're [we are]	weere
what	waht	whta
when	wehn
whereas	wheras
wherever	whereever
which	hwihc	whcih	whic	whihc
which, witch	whitch	wich
while	hwile
whining, winning	whinning
whole	hwole	wohle
wholly	wholely	wholey	wholley
who's, whose	whos
wielded	weilded
wield, wild	weild
wife	wief
wife's, wives	wifes
will	iwll	wiull
Wisconsin	Wisconson
witches	witchs
with	iwth	wiht	witht	wtih
withdrawal, withdraw	withdrawl
withhold	withold
within	withing
without	wihtout
with the	withthe
witness	wittness
women's	womens'
women, women's	womens
won't	wont
wore, worn	weared
work	owrk	wokr	wrok
working	wokring	wroking
worldwide	worlwide
worsen	worsten
worsened	worstened
worsening	worstening
would	owudl	woudl
write	rwite	wriet
writer	writter
writing	wirting	writting
written	writen
written, wrote	writed	wroten
wrote	wroet
Xbox	X-Box
yacht	yatch
y'all	ya'll
year	yera
year, eyas	eyar
years	yeasr	yeras	yersa
years, eyas	eyars	eyasr
yellow	yelow
Yemenite, Yemeni	Yementite
yield	yeild
you	ytou	yuo
younger	yuonger
your	ur
yourself	youself
zebra	zeebra
Ziegfeld Follies	Ziegfield Follies
Zionist	Sionist
Zionists	Sionists
Null